######
###o##
##ooo#
###o##
######
