######
###o##
##nao#
###o##
######
